20
00000000000000000000
01011111011111111100
01000100000001000000
11110111011111011100
00010001010001010000
01110111110101110100
01010101000101010100
01011101110111011100
00010100000000000000
01110111011111110100
01010000010000010100
01010111010101010100
01010100010101010100
01010111010111011111
00010101000001010000
01111101111111111100
01000001000000010000
01011111011111111100
00000000000000000000
00000000000000000000
